#################################################
#               #                               #
#               #                               E
#               #                               #
#               # ###### ########   #############
#               # #             #   #           #
#               # #   OOOOOOO   #   #        OOO#
############# ### #         O   #               #
#                 #         O   #   #   OOOOO   #
#   ##########    #         O   #   #   OOOOO   #
E   #                 OOOOOOO   #   #   OOOOO   #
#   #        #    #             #   #           #
##################################E##############