############
#..........#
#..######..#
#..#....#..#
E..........E
#..#....#..#
#..######..#
#..........#
############