##############################
#.......#............#.......#
#.......#............#.......#
#.......#....####....#.......#
#.......#....####....#.......#
E...#####............#####...E
#............####............#
#............####............#
#######................#######
#.....#................#.....#
#.....#.......##.......#.....#
#.....#.......##.......#.....#
E.....##########.......#.....E
#..............#.......#.....#
#..............#.......#.....#
###.####.......#########.....#
#......#.......#.............#
#......#.......#.............#
#......#.......#.............#
##############################