########################################
E......................................E
#..####..####..####..####..####..####..#
#..#..#..#..#..#..#..#..#..#..#..#..#..#
#......................................#
#......................................#
#..####..####..####..####..####..####..#
E......................................E
########################################