####################
#..................#
#..####......####..#
E..................E
#..####......####..#
#..................#
#.......####.......#
#.......####.......#
#..................#
####################